Header :duration 120:width 400:durGridWidth 3:
Point
T: 0:E: Gnn0 Gnn0 Gnn0 Gnn0 Gnn0 Gnn0 Gnn0 Gnn0 Gnn0 Gnn0 Gnn0:end
T: 1:E: 0nn0 0nn0 0nn0 0nn0 0nn0 0nn0 0nn0 0nn0 0nn0 0nn0 0nn0:end
T: 2:E: Gnn0 Gnn0 Gnn0 Gnn0 Gnn0 Gnn0 Gnn0 Gnn0 Gnn0 Gnn0 Gnn0:end
T: 3:E: 0nn0 0nn0 0nn0 0nn0 0nn0 0nn0 0nn0 0nn0 0nn0 0nn0 0nn0:end
T: 4:E: Gnn0 Gnn0 Gnn0 Gnn0 Gnn0 Gnn0 Gnn0 Gnn0 Gnn0 Gnn0 Gnn0:end
T: 5:E: 0nn0 0nn0 RfotH2X30Y30 0nn0 0nn0 0nn0 0nn0 0nn0 RfotH2X30Y30 0nn0 0nn0:end
T: 6:E: Gnn0 Gnn0 Gnn0 Gnn0 Gnn0 Gnn0 Gnn0 Gnn0 Gnn0 Gnn0 Gnn0:end
T: 7:E: 0nn0 0nn0 0nn0 0nn0 0fo0 0nn0 0fo0 0nn0 0nn0 0nn0 0nn0:end
T: 8:E: Gnn0 Gnn0 Gnn0 Gnn0 Gnn0 Gnn0 Gnn0 Gnn0 Gnn0 Gnn0 Gnn0:end
T: 9:E: 0nn0 RfotH2X30Y30 0nn0 0nn0 0nn0 RfotH2X30Y30 0nn0 0nn0 0nn0 RfotH2X30Y30 0nn0:end
T: 10:E: Gnn0 Gnn0 Gnn0 Gnn0 Gnn0 Gnn0 Gnn0 Gnn0 Gnn0 Gnn0 Gnn0:end
T: 11:E: Gnn0 Gnn0 Gnn0 Gnn0 Gnn0 Gnn0 Gnn0 Gnn0 Gnn0 Gnn0 Gnn0:end
T: 12:E: Gnn0 Gnn0 Gnn0 Gnn0 Gnn0 Gnn0 Gnn0 Gnn0 Gnn0 Gnn0 Gnn0:end
T: 13:E: Gnn0 Gnn0 Gnn0 Gnn0 Gnn0 Gnn0 Gnn0 Gnn0 Gnn0 Gnn0 Gnn0:end
T: 14:E: Gnn0 Gnn0 Gnn0 Gnn0 Gnn0 Gnn0 Gnn0 Gnn0 Gnn0 Gnn0 Gnn0:end
T: 15:E: 0nn0 0nn0 0nn0 0nn0 0nn0 0nn0 0nn0 0nn0 0nn0 0nn0 0nn0:end
T: 16:E: 0nn0 0nn0 0nn0 0nn0 0nn0 0nn0 0nn0 0nn0 0nn0 0nn0 0nn0:end
T: 17:E: 0nn0 0nn0 YfosH3W4X60Y60 0nn0 0nn0 0nn0 0nn0 0nn0 YfosH3W4X60Y60 0nn0 0nn0:end
T: 18:E: 0nn0 0nn0 0fo0 0nn0 0nn0 0nn0 0nn0 0nn0 0fo0 0nn0 0nn0:end
T: 19:E: 0nn0 0nn0 0nn0 0nn0 0nn0 0nn0 0nn0 0nn0 0nn0 0nn0 0nn0:end
T: 20:E: 0nn0 0nn0 Ost0 0nn0 0nn0 0nn0 0nn0 0nn0 Ost0 0nn0 0nn0:end
T: 21:E: 0nn0 0nn0 0nn0 0nn0 0nn0 0nn0 0nn0 0nn0 0nn0 0nn0 0nn0:end
T: 22:E: 0nn0 0nn0 0nn0 0nn0 0nn0 0nn0 0nn0 0nn0 0nn0 0nn0 0nn0:end
T: 23:E: 0nn0 0nn0 0nn0 0nn0 0nn0 0nn0 0nn0 0nn0 0nn0 0nn0 0nn0:end
T: 24:E: 0nn0 0nn0 0nn0 0nn0 0nn0 0nn0 0nn0 0nn0 0nn0 0nn0 0nn0:end
T: 25:E: 0nn0 0nn0 0nn0 0nn0 0nn0 0nn0 0nn0 0nn0 0nn0 0nn0 0nn0:end
T: 26:E: Tnn0 0nn0 0nn0 0nn0 0nn0 Tnn0 0nn0 0nn0 0nn0 0nn0 Tnn0:end
T: 27:E: 0nn0 0nn0 0nn0 0nn0 0nn0 0nn0 0nn0 0nn0 0nn0 0nn0 0nn0:end
T: 28:E: 0nn0 0nn0 YnnsH4W4X60Y60 0nn0 0nn0 0nn0 0nn0 0nn0 YnnsH4W4X60Y60 0nn0 0nn0:end
T: 29:E: Gnn0 Gnn0 Gnn0 Gnn0 Gnn0 Gnn0 Gnn0 Gnn0 Gnn0 Gnn0 Gnn0:end
T: 30:E: 0nn0 0nn0 0nn0 0nn0 0nn0 0nn0 0nn0 0nn0 0nn0 0nn0 0nn0:end
T: 31:E: 0nn0 0nn0 0nn0 0nn0 0nn0 0nn0 0nn0 0nn0 0nn0 0nn0 0nn0:end
T: 32:E: 0nn0 Ost0 0nn0 0nn0 0nn0 Ost0 0nn0 0nn0 0nn0 Ost0 0nn0:end
T: 33:E: 0nn0 0nn0 0nn0 0nn0 0nn0 0nn0 0nn0 0nn0 0nn0 0nn0 0nn0:end
T: 34:E: 0nn0 0nn0 0nn0 0nn0 0nn0 0nn0 0nn0 0nn0 0nn0 0nn0 0nn0:end
T: 35:E: 0nn0 0nn0 0nn0 0nn0 0nn0 0nn0 0nn0 0nn0 0nn0 0nn0 0nn0:end
T: 36:E: 0nn0 0nn0 0nn0 0nn0 0nn0 Lc10 0nn0 0nn0 0nn0 0nn0 0nn0:end
T: 37:E: 0nn0 0nn0 0nn0 0nn0 0nn0 0nn0 0nn0 0nn0 0nn0 0nn0 0nn0:end
T: 38:E: 0nn0 0nn0 Lc10 0nn0 0nn0 0nn0 0nn0 0nn0 Lc10 0nn0 0nn0:end
T: 39:E: 0nn0 0nn0 0nn0 0nn0 0nn0 0nn0 0nn0 0nn0 0nn0 0nn0 0nn0:end
T: 40:E: 0nn0 0nn0 0nn0 0nn0 0nn0 0nn0 0nn0 0nn0 0nn0 0nn0 0nn0:end
T: 41:E: 0nn0 Lc10 0nn0 0nn0 0nn0 0nn0 0nn0 0nn0 0nn0 Lc10 0nn0:end
T: 42:E: 0nn0 0nn0 0nn0 0nn0 0nn0 0nn0 0nn0 0nn0 0nn0 0nn0 0nn0:end
T: 43:E: 0nn0 0nn0 0nn0 0nn0 0nn0 0nn0 0nn0 0nn0 0nn0 0nn0 0nn0:end
T: 44:E: 0nn0 0nn0 Lc10 0nn0 0nn0 0nn0 0nn0 0nn0 Lc10 0nn0 0nn0:end
T: 45:E: 0nn0 0nn0 0nn0 0nn0 0nn0 0nn0 0nn0 0nn0 0nn0 0nn0 0nn0:end
T: 46:E: 0nn0 0nn0 0nn0 0nn0 0nn0 Lc10 0nn0 0nn0 0nn0 0nn0 0nn0:end
T: 47:E: 0nn0 0nn0 0nn0 0nn0 0nn0 0nn0 0nn0 0nn0 0nn0 0nn0 0nn0:end
T: 48:E: 0nn0 0nn0 0nn0 0nn0 0nn0 0nn0 0nn0 0nn0 0nn0 0nn0 0nn0:end
T: 49:E: 0nn0 0nn0 0nn0 0nn0 0nn0 0nn0 0nn0 0nn0 0nn0 0nn0 0nn0:end
T: 50:E: 0nn0 0nn0 Bzz0 0nn0 0nn0 Bzz0 0nn0 0nn0 Bzz0 0nn0 0nn0:end
T: 51:E: 0nn0 0nn0 0nn0 0nn0 0nn0 0nn0 0nn0 0nn0 0nn0 0nn0 0nn0:end
T: 52:E: 0nn0 0nn0 0nn0 0nn0 0nn0 0nn0 0nn0 0nn0 0nn0 0nn0 0nn0:end
T: 53:E: 0nn0 0nn0 0nn0 Bzz0 0nn0 0nn0 0nn0 Bzz0 0nn0 0nn0 0nn0:end
T: 54:E: 0nn0 0nn0 0nn0 0nn0 0nn0 0nn0 0nn0 0nn0 0nn0 0nn0 0nn0:end
T: 55:E: 0nn0 0nn0 0nn0 0nn0 0nn0 0nn0 0nn0 0nn0 0nn0 0nn0 0nn0:end
T: 56:E: 0nn0 0nn0 0nn0 0nn0 Bzz0 0nn0 Bzz0 0nn0 0nn0 0nn0 0nn0:end
T: 57:E: 0nn0 0nn0 0nn0 0nn0 0nn0 0nn0 0nn0 0nn0 0nn0 0nn0 0nn0:end
T: 58:E: 0nn0 0nn0 Inn0 0nn0 Inn0 0nn0 Inn0 0nn0 Inn0 0nn0 0nn0:end
T: 59:E: 0nn0 0nn0 Bzz0 0nn0 0nn0 Bzz0 0nn0 0nn0 Bzz0 0nn0 0nn0:end
T: 60:E: 0nn0 0nn0 0nn0 0nn0 0nn0 0nn0 0nn0 0nn0 0nn0 0nn0 0nn0:end
T: 61:E: 0nn0 0nn0 0nn0 0nn0 0nn0 0nn0 0nn0 0nn0 0nn0 0nn0 0nn0:end
T: 62:E: 0nn0 0nn0 0nn0 0nn0 0nn0 0nn0 0nn0 0nn0 0nn0 0nn0 0nn0:end
T: 63:E: 0nn0 0nn0 0nn0 0nn0 0nn0 0nn0 0nn0 0nn0 0nn0 0nn0 0nn0:end
T: 64:E: 0nn0 0nn0 0nn0 0nn0 0nn0 0nn0 0nn0 0nn0 0nn0 0nn0 0nn0:end
T: 65:E: 0nn0 0nn0 0nn0 0nn0 0nn0 0nn0 0nn0 0nn0 0nn0 0nn0 0nn0:end
T: 66:E: 0nn0 0nn0 MstlW2X30 0nn0 0nn0 MstlW2X30 0nn0 0nn0 MstlW2X30 0nn0 0nn0:end
T: 67:E: 0nn0 0nn0 0nn0 0nn0 0nn0 0nn0 0nn0 0nn0 0nn0 0nn0 0nn0:end
T: 68:E: 0nn0 0nn0 0nn0 0nn0 0nn0 0nn0 0nn0 0nn0 0nn0 0nn0 0nn0:end
T: 69:E: 0nn0 0nn0 0nn0 0nn0 0nn0 0nn0 0nn0 0nn0 0nn0 0nn0 0nn0:end
T: 70:E: 0nn0 0nn0 0nn0 0nn0 0nn0 0nn0 0nn0 0nn0 0nn0 0nn0 0nn0:end
T: 71:E: 0nn0 0nn0 0nn0 0nn0 0nn0 0nn0 0nn0 0nn0 0nn0 0nn0 0nn0:end
T: 72:E: 0nn0 0nn0 0nn0 0nn0 0nn0 0nn0 0nn0 0nn0 0nn0 0nn0 0nn0:end
T: 73:E: 0nn0 0nn0 0nn0 0nn0 0nn0 0nn0 0nn0 0nn0 0nn0 0nn0 0nn0:end
T: 74:E: 0nn0 0nn0 0nn0 0nn0 0nn0 0nn0 0nn0 0nn0 0nn0 0nn0 0nn0:end
T: 75:E: 0nn0 0nn0 0nn0 0nn0 0nn0 0nn0 0nn0 0nn0 0nn0 0nn0 0nn0:end
T: 76:E: 0nn0 0nn0 0nn0 0nn0 0nn0 0nn0 0nn0 0nn0 0nn0 0nn0 0nn0:end
T: 77:E: 0nn0 0nn0 0nn0 0nn0 0nn0 0nn0 0nn0 0nn0 0nn0 0nn0 0nn0:end
T: 78:E: 0nn0 0nn0 0nn0 0nn0 0nn0 0nn0 0nn0 0nn0 0nn0 0nn0 0nn0:end
T: 79:E: 0nn0 0nn0 0nn0 0nn0 0nn0 0nn0 0nn0 0nn0 0nn0 0nn0 0nn0:end
T: 80:E: 0nn0 0nn0 0nn0 0nn0 0nn0 0nn0 0nn0 0nn0 0nn0 0nn0 0nn0:end
T: 81:E: 0nn0 0nn0 0nn0 0nn0 0nn0 0nn0 0nn0 0nn0 0nn0 0nn0 0nn0:end
T: 82:E: 0nn0 0nn0 0nn0 0nn0 0nn0 0nn0 0nn0 0nn0 0nn0 0nn0 0nn0:end
T: 83:E: 0nn0 0nn0 0nn0 0nn0 0nn0 0nn0 0nn0 0nn0 0nn0 0nn0 0nn0:end
T: 84:E: 0nn0 0nn0 0nn0 0nn0 0nn0 0nn0 0nn0 0nn0 0nn0 0nn0 0nn0:end
T: 85:E: 0nn0 0nn0 0nn0 0nn0 0nn0 0nn0 0nn0 0nn0 0nn0 0nn0 0nn0:end
T: 86:E: 0nn0 0nn0 0nn0 0nn0 0nn0 0nn0 0nn0 0nn0 0nn0 0nn0 0nn0:end
T: 87:E: 0nn0 0nn0 0nn0 0nn0 0nn0 0nn0 0nn0 0nn0 0nn0 0nn0 0nn0:end
T: 88:E: 0nn0 0nn0 0nn0 0nn0 0nn0 0nn0 0nn0 0nn0 0nn0 0nn0 0nn0:end
T: 89:E: 0nn0 0nn0 0nn0 0nn0 0nn0 0nn0 0nn0 0nn0 0nn0 0nn0 0nn0:end
T: 90:E: 0nn0 0nn0 0nn0 0nn0 0nn0 0nn0 0nn0 0nn0 0nn0 0nn0 0nn0:end
T: 91:E: 0nn0 0nn0 0nn0 0nn0 0nn0 0nn0 0nn0 0nn0 0nn0 0nn0 0nn0:end
T: 92:E: 0nn0 0nn0 0nn0 0nn0 0nn0 0nn0 0nn0 0nn0 0nn0 0nn0 0nn0:end
T: 93:E: 0nn0 0nn0 0nn0 0nn0 0nn0 0nn0 0nn0 0nn0 0nn0 0nn0 0nn0:end
T: 94:E: 0nn0 0nn0 0nn0 0nn0 0nn0 0nn0 0nn0 0nn0 0nn0 0nn0 0nn0:end
T: 95:E: 0nn0 0nn0 0nn0 0nn0 0nn0 0nn0 0nn0 0nn0 0nn0 0nn0 0nn0:end
T: 96:E: 0nn0 0nn0 0nn0 0nn0 0nn0 0nn0 0nn0 0nn0 0nn0 0nn0 0nn0:end
T: 97:E: 0nn0 0nn0 0nn0 0nn0 0nn0 0nn0 0nn0 0nn0 0nn0 0nn0 0nn0:end
T: 98:E: 0nn0 0nn0 0nn0 0nn0 0nn0 0nn0 0nn0 0nn0 0nn0 0nn0 0nn0:end
T: 99:E: 0nn0 0nn0 0nn0 0nn0 0nn0 0nn0 0nn0 0nn0 0nn0 0nn0 0nn0:end
T: 100:E: 0nn0 0nn0 0nn0 0nn0 0nn0 0nn0 0nn0 0nn0 0nn0 0nn0 0nn0:end
T: 101:E: 0nn0 0nn0 0nn0 0nn0 0nn0 0nn0 0nn0 0nn0 0nn0 0nn0 0nn0:end
T: 102:E: 0nn0 0nn0 0nn0 0nn0 0nn0 0nn0 0nn0 0nn0 0nn0 0nn0 0nn0:end
T: 103:E: 0nn0 0nn0 0nn0 0nn0 0nn0 0nn0 0nn0 0nn0 0nn0 0nn0 0nn0:end
T: 104:E: 0nn0 0nn0 0nn0 0nn0 0nn0 0nn0 0nn0 0nn0 0nn0 0nn0 0nn0:end
T: 105:E: 0nn0 0nn0 0nn0 0nn0 0nn0 0nn0 0nn0 0nn0 0nn0 0nn0 0nn0:end
T: 106:E: 0nn0 0nn0 0nn0 0nn0 0nn0 0nn0 0nn0 0nn0 0nn0 0nn0 0nn0:end
T: 107:E: 0nn0 0nn0 0nn0 0nn0 0nn0 0nn0 0nn0 0nn0 0nn0 0nn0 0nn0:end
T: 108:E: 0nn0 0nn0 0nn0 0nn0 0nn0 0nn0 0nn0 0nn0 0nn0 0nn0 0nn0:end
T: 109:E: 0nn0 0nn0 0nn0 0nn0 0nn0 0nn0 0nn0 0nn0 0nn0 0nn0 0nn0:end
T: 110:E: 0nn0 Tst0 0nn0 0nn0 0nn0 Tst0 0nn0 0nn0 0nn0 Tst0 0nn0:end
T: 111:E: 0nn0 0nn0 0nn0 0nn0 0nn0 0nn0 0nn0 0nn0 0nn0 0nn0 0nn0:end
T: 112:E: 0nn0 0nn0 0nn0 0nn0 0nn0 0nn0 0nn0 0nn0 0nn0 0nn0 0nn0:end
T: 113:E: 0nn0 Lst0 0nn0 0nn0 0nn0 Lst0 0nn0 0nn0 0nn0 Lst0 0nn0:end
T: 114:E: 0nn0 0nn0 0nn0 0nn0 0nn0 0nn0 0nn0 0nn0 0nn0 0nn0 0nn0:end
T: 115:E: 0nn0 0nn0 0nn0 0nn0 0nn0 0nn0 0nn0 0nn0 0nn0 0nn0 0nn0:end
T: 116:E: 0nn0 0nn0 0nn0 0nn0 0nn0 0nn0 0nn0 0nn0 0nn0 0nn0 0nn0:end
T: 117:E: 0nn0 0nn0 0nn0 0nn0 0nn0 0nn0 0nn0 0nn0 0nn0 0nn0 0nn0:end
T: 118:E: 0nn0 0nn0 0nn0 0nn0 0nn0 0nn0 0nn0 0nn0 0nn0 0nn0 0nn0:end
T: 119:E: 0nn0 Yst0 0nn0 Yst0 0nn0 Yst0 0nn0 Yst0 0nn0 Yst0 0nn0:end
Duration
C:0,22 0,23:E: SnnED1000
C:0,33 0,34:E: SnnED1000
C:0,28 0,29:E: SnnED1000
C:1,33 1,35:E: GstED100
C:0,36 0,46:E: Rc1ED30
C:0,90 0,119:E: GnnGP100S10T100
C:2,109 2,110:E: SnnED1000
C:0,82 0,83:E: SslED500
C:2,92 2,93:E: SslED500
C:2,99 2,100:E: SslED500
C:2,73 2,86:E: HstED10
