Header :duration 70:width 600:durGridWidth 3:levelObjective Finish|X0:
Point
T: 0:E: 0nn0 0nn0 0nn0 0nn0 Ann0 0nn0 Ann0 0nn0 0nn0 0nn0 0nn0:end
T: 1,3:E: 0nn0 0nn0 0nn0 0nn0 0nn0 0nn0 0nn0 0nn0 0nn0 0nn0 0nn0:end
T: 2,6:E: 0nn0 0nn0 Tnn0 0nn0 0nn0 0nn0 0nn0 0nn0 Tnn0 0nn0 0nn0:end
T: 4:E: 0nn0 0nn0 0nn0 0nn0 0nn0 alntH4X50Y30 0nn0 0nn0 0nn0 0nn0 0nn0:end
T: 5,3:E: 0nn0 0nn0 0nn0 0nn0 0nn0 0nn0 0nn0 0nn0 0nn0 0nn0 0nn0:end
T: 6,6:E: 0nn0 0nn0 0nn0 0nn0 0nn0 0nn0 0nn0 0nn0 0nn0 0nn0 0nn0:end
T: 7,9:E: 0nn0 0nn0 0nn0 0nn0 0nn0 0nn0 0nn0 0nn0 0nn0 0nn0 0nn0:end
T: 9,2:E: bc10 0nn0 0nn0 0nn0 0nn0 0nn0 0nn0 0nn0 0nn0 0nn0 0nn0:end
T: 10,6:E: 0c10 0nn0 0nn0 0nn0 0nn0 0nn0 0nn0 0nn0 0nn0 0nn0 0nn0:end
T: 11,9:E: 0c10 0nn0 0nn0 0nn0 0nn0 0nn0 0nn0 0nn0 0nn0 0nn0 0nn0:end
T: 13,2:E: bc10 0nn0 0c10 0nn0 0nn0 0nn0 0nn0 0nn0 0c10 0nn0 0nn0:end
T: 14,5:E: 0nn0 0nn0 0nn0 0nn0 0nn0 0nn0 0nn0 0nn0 0nn0 0nn0 0nn0:end
T: 15,8:E: 0nn0 0nn0 0nn0 0nn0 ann0 0nn0 0nn0 0nn0 ann0 0nn0 0nn0:end
T: 17,2:E: 0nn0 0nn0 Tc10 0nn0 0nn0 0nn0 0nn0 0nn0 0c10 0nn0 0nn0:end
T: 18,5:E: 0nn0 0nn0 0nn0 0nn0 0nn0 0nn0 0nn0 0nn0 0c10 0nn0 0nn0:end
T: 19,8:E: 0nn0 0nn0 0nn0 0nn0 0nn0 0nn0 0nn0 0nn0 Tc10 0nn0 0nn0:end
T: 21,1:E: 0nn0 0nn0 ann0 0nn0 0nn0 0nn0 0nn0 0nn0 0nn0 0nn0 0nn0:end
T: 22,5:E: 0nn0 0nn0 0nn0 0nn0 0nn0 0nn0 0nn0 0nn0 0nn0 0nn0 0nn0:end
T: 23,8:E: 0nn0 0nn0 0nn0 0nn0 0nn0 0nn0 0nn0 0nn0 0nn0 0nn0 0nn0:end
T: 25,1:E: 0nn0 ann0 0c10 0nn0 0nn0 0nn0 0nn0 0nn0 0c10 0nn0 0nn0:end
T: 26,4:E: 0nn0 0nn0 0nn0 Nc10 0nn0 0nn0 0c10 Nc10 0nn0 0nn0 0nn0:end
T: 27,7:E: 0nn0 0nn0 0nn0 0nn0 0nn0 0nn0 0nn0 0nn0 0nn0 0nn0 0nn0:end
T: 29,1:E: 0nn0 0nn0 0nn0 0nn0 0nn0 0nn0 0nn0 0nn0 ann0 0nn0 0nn0:end
T: 30,4:E: 0nn0 0nn0 0nn0 ann0 0nn0 0nn0 0nn0 0nn0 0nn0 0nn0 0nn0:end
T: 31,7:E: 0nn0 0nn0 0nn0 0nn0 0nn0 0nn0 0nn0 0nn0 0nn0 0nn0 0nn0:end
T: 33:E: 0nn0 0nn0 0c10 0nn0 0nn0 0nn0 0nn0 0nn0 Tc10 0nn0 0nn0:end
T: 34,3:E: 0nn0 0nn0 0c10 0nn0 0nn0 0nn0 0nn0 0nn0 0nn0 0nn0 0nn0:end
T: 35,7:E: 0nn0 0nn0 Tc10 0nn0 0nn0 0nn0 0nn0 0nn0 0nn0 0nn0 0nn0:end
T: 37:E: 0nn0 0nn0 0nn0 0nn0 0nn0 0nn0 ann0 0nn0 0nn0 0nn0 0nn0:end
T: 38,3:E: 0nn0 0nn0 0nn0 0nn0 0nn0 0nn0 0nn0 0nn0 0nn0 0nn0 0nn0:end
T: 39,6:E: 0nn0 0nn0 0nn0 0nn0 0nn0 0nn0 0nn0 0nn0 0nn0 0nn0 0nn0:end
T: 40,9:E: 0nn0 0nn0 ann0 0nn0 0nn0 0nn0 0nn0 0nn0 ann0 0nn0 0nn0:end
T: 42,3:E: 0nn0 0nn0 0nn0 0nn0 0nn0 0nn0 0nn0 0nn0 0nn0 0nn0 0nn0:end
T: 43,6:E: 0nn0 0nn0 0nn0 0nn0 0nn0 mnn0 0nn0 0nn0 0nn0 0nn0 0nn0:end
T: 44,9:E: 0nn0 0nn0 0nn0 0nn0 0nn0 0nn0 0nn0 0nn0 0nn0 0nn0 0nn0:end
T: 46,2:E: 0nn0 0nn0 0nn0 0nn0 0nn0 0nn0 0nn0 0nn0 0nn0 0nn0 0nn0:end
T: 47,5:E: 0nn0 0nn0 0nn0 0nn0 0nn0 0nn0 0nn0 0nn0 0nn0 0nn0 0nn0:end
T: 48,9:E: 0nn0 0nn0 0nn0 0nn0 0nn0 0nn0 0nn0 0nn0 0nn0 0nn0 0nn0:end
T: 50,2:E: 0nn0 0nn0 0nn0 0nn0 0nn0 0nn0 0nn0 0nn0 0nn0 0nn0 0nn0:end
T: 51,5:E: 0nn0 0nn0 0nn0 0nn0 0nn0 0nn0 0nn0 0nn0 0nn0 0nn0 0nn0:end
T: 52,8:E: 0nn0 0nn0 0nn0 0nn0 0nn0 0nn0 0nn0 0nn0 0nn0 0nn0 0nn0:end
T: 54,2:E: 0nn0 0nn0 0nn0 0nn0 0nn0 0nn0 0nn0 0nn0 0nn0 0nn0 0nn0:end
T: 55,5:E: 0nn0 0nn0 0nn0 0nn0 0nn0 0nn0 0nn0 0nn0 0nn0 0nn0 0nn0:end
T: 56,8:E: 0nn0 0nn0 0nn0 0nn0 0nn0 0nn0 0nn0 0nn0 0nn0 0nn0 0nn0:end
T: 58,1:E: 0nn0 0nn0 0nn0 0nn0 0nn0 0nn0 0nn0 0nn0 0nn0 0nn0 0nn0:end
T: 59,4:E: 0nn0 0nn0 0nn0 0nn0 0nn0 0nn0 0nn0 0nn0 0nn0 0nn0 0nn0:end
T: 60,8:E: 0nn0 0nn0 0nn0 0nn0 0nn0 0nn0 0nn0 0nn0 0nn0 0nn0 0nn0:end
T: 62,1:E: 0nn0 0nn0 0nn0 0nn0 0nn0 0nn0 0nn0 0nn0 0nn0 0nn0 0nn0:end
T: 63,4:E: 0nn0 0nn0 0nn0 0nn0 0nn0 0nn0 0nn0 0nn0 0nn0 0nn0 0nn0:end
T: 64,7:E: 0nn0 0nn0 0nn0 0nn0 0nn0 0nn0 0nn0 0nn0 0nn0 0nn0 0nn0:end
T: 66:E: 0nn0 0nn0 0nn0 0nn0 0nn0 0nn0 0nn0 0nn0 0nn0 0nn0 0nn0:end
T: 67,4:E: 0nn0 0nn0 0nn0 0nn0 0nn0 0nn0 0nn0 0nn0 0nn0 0nn0 0nn0:end
T: 68,7:E: 0nn0 0nn0 0nn0 0nn0 0nn0 0nn0 0nn0 0nn0 0nn0 0nn0 0nn0:end
Duration
